5 5 5 5 5 5 5 5 5 5 5 5 5 5 5 5 5 5 5 5 5 5 5 5 5 5 5 5 5 5 5 5 5 5 5 5 5 5 5 5 5 5 5 5 5 5 5 5 5 5 
5 2 2 2 2 3 3 3 2 3 3 2 2 2 3 2 3 3 2 2 2 3 3 2 2 3 3 3 3 3 3 2 3 2 2 3 2 2 3 2 3 2 3 2 2 2 3 3 2 5 
5 3 3 2 2 2 3 2 2 2 3 2 3 2 2 3 2 3 2 2 2 2 3 3 2 2 3 3 3 3 2 3 3 2 3 3 3 3 3 2 3 3 2 3 3 3 3 2 3 5 
5 2 3 2 2 3 2 3 2 3 3 2 2 2 3 2 2 2 2 2 2 3 3 3 3 2 3 2 3 3 2 3 2 3 3 2 2 2 2 3 3 3 3 3 3 3 2 3 3 5 
5 3 2 3 2 2 3 3 3 3 3 2 2 3 3 3 3 3 2 3 2 3 2 3 3 2 2 2 3 2 2 2 2 3 2 2 2 2 3 2 2 3 2 2 2 2 3 2 3 5 
5 2 3 2 2 2 3 2 3 3 3 3 2 2 2 2 2 3 2 3 3 2 3 3 3 3 2 3 2 3 3 3 3 3 2 3 2 3 3 3 3 2 2 2 3 2 2 2 3 5 
5 3 3 2 3 3 2 3 2 3 3 2 2 3 3 2 2 2 3 3 2 3 3 3 2 3 3 3 2 2 2 2 3 2 2 3 3 3 3 3 3 2 2 3 2 3 3 2 3 5 
5 3 2 3 2 3 2 2 3 3 2 3 2 2 3 2 2 2 3 3 2 2 2 2 2 3 2 3 2 2 5 5 5 5 5 5 5 2 2 2 2 3 2 2 2 2 2 2 2 5
5 3 2 3 3 3 2 3 2 2 2 3 3 2 3 2 2 3 3 2 3 2 2 3 3 3 3 3 3 2 5 1 1 1 1 1 5 3 2 2 3 3 2 3 3 3 3 3 2 5
5 3 3 2 3 3 3 3 3 3 2 3 2 3 3 2 3 3 2 3 3 3 3 2 2 2 2 2 3 3 5 1 1 1 1 1 5 3 2 3 3 2 2 3 2 3 3 2 3 5
5 3 2 3 3 3 2 3 3 3 3 3 3 3 3 3 3 3 3 3 2 3 3 2 3 2 3 3 2 2 5 1 1 1 1 1 5 3 3 3 2 2 2 3 3 3 3 3 2 5
5 2 3 2 2 2 3 3 3 3 3 3 3 3 3 3 3 3 3 3 2 3 3 2 3 3 2 2 2 3 5 1 1 1 1 1 5 3 3 3 2 3 3 3 3 2 2 3 3 5
5 2 3 3 3 2 2 3 3 3 3 3 3 3 3 3 3 3 3 3 2 3 2 3 2 2 2 2 2 2 5 5 5 4 5 5 5 3 3 2 3 2 3 3 2 3 3 3 2 5
5 2 2 3 3 2 2 3 2 3 3 3 3 3 3 3 3 3 3 3 3 2 3 3 2 2 3 2 3 3 3 3 5 4 5 2 3 2 3 3 3 2 2 2 2 2 3 3 2 5
5 2 3 3 2 2 3 2 2 2 3 3 3 3 3 3 3 3 3 3 2 2 2 2 2 2 2 3 2 3 3 3 5 4 5 3 2 3 3 2 2 2 3 2 2 2 3 2 2 5
5 2 3 3 3 2 3 3 3 3 3 3 3 3 3 3 3 3 3 3 3 3 3 3 2 3 2 3 3 3 2 2 5 4 5 3 3 2 3 3 3 3 2 3 2 3 3 2 2 5
5 2 3 3 2 2 3 2 3 3 3 3 3 3 3 3 3 3 3 3 3 3 3 2 3 2 2 3 2 2 2 2 2 2 3 3 3 2 2 2 3 2 3 2 3 3 3 3 3 5 
5 3 3 2 3 3 3 2 3 3 3 3 3 3 3 3 3 3 3 3 3 2 3 3 2 2 2 3 3 3 2 3 3 3 3 3 2 3 2 3 2 3 3 2 2 2 2 3 2 5 
5 2 2 2 3 3 2 2 3 2 3 3 3 3 3 3 3 3 3 3 2 3 2 2 2 3 3 3 3 2 3 3 2 2 2 2 3 3 3 3 2 3 2 2 3 2 3 3 3 5 
5 3 3 2 3 2 3 3 2 2 3 3 3 3 3 3 3 3 3 3 3 2 2 2 2 3 2 2 3 3 2 2 3 2 2 3 2 3 3 2 3 3 3 2 3 2 2 2 2 5 
5 2 3 3 3 2 3 3 3 3 3 3 3 3 2 2 2 3 2 3 3 3 3 3 2 3 3 2 3 2 2 3 2 2 2 3 2 3 2 2 3 3 2 3 3 3 2 3 3 5 
5 3 3 3 2 3 3 3 2 2 2 2 3 3 2 2 3 2 3 3 2 3 2 2 2 2 2 2 2 3 3 3 2 2 3 3 3 2 2 2 3 3 3 2 2 3 2 3 3 5 
5 3 2 3 3 2 2 3 2 2 2 2 3 3 2 3 3 3 3 3 2 2 2 3 3 3 2 2 3 2 3 3 3 2 2 3 3 3 2 3 3 3 2 3 3 3 2 3 2 5 
5 2 3 3 2 2 3 2 2 3 3 3 2 2 2 2 3 2 3 2 2 2 2 2 2 3 3 2 3 3 3 2 3 2 3 3 3 2 2 3 3 3 3 2 3 2 2 3 2 5 
5 3 3 2 2 3 2 3 3 3 3 2 3 3 3 3 2 2 3 2 3 2 3 3 3 3 3 3 3 3 2 3 3 3 2 3 2 2 2 3 2 3 2 2 3 3 3 2 3 5 
5 3 2 3 3 3 3 2 3 3 3 3 2 3 3 2 2 2 2 3 3 3 3 3 3 2 3 2 3 3 2 2 2 3 3 3 3 2 2 3 2 3 2 2 3 3 2 2 3 5 
5 2 3 2 3 3 3 3 3 3 2 3 3 2 3 2 3 2 2 3 3 2 2 2 3 3 3 3 2 3 3 3 3 2 2 3 3 3 3 3 2 2 2 3 2 3 3 3 2 5 
5 3 3 3 3 2 3 2 3 2 3 3 2 3 3 2 2 2 2 3 3 3 2 3 3 2 3 2 3 3 2 2 3 2 3 3 2 2 2 2 2 2 2 2 2 3 2 2 3 5 
5 2 3 3 3 2 2 3 3 2 3 3 3 2 2 2 2 3 3 3 2 3 3 2 3 2 3 2 2 2 3 2 2 2 3 2 2 2 2 2 3 2 3 3 2 3 2 2 3 5 
5 3 2 3 3 3 3 2 2 3 2 2 3 3 2 2 3 3 2 2 3 3 3 3 3 2 3 3 3 3 3 3 3 2 2 2 2 2 3 3 2 2 2 2 3 2 3 3 2 5 
5 3 2 2 3 3 2 3 3 3 2 3 3 3 3 3 3 3 2 3 3 3 2 3 2 2 3 3 2 3 2 3 3 3 2 3 2 3 2 3 3 3 2 2 2 3 3 3 3 5 
5 3 2 2 3 2 3 3 3 2 2 2 2 3 3 2 3 3 2 3 2 3 3 2 3 2 3 2 2 2 2 2 3 2 3 2 3 2 2 3 3 2 3 2 3 2 3 3 3 5 
5 2 3 3 2 2 2 3 2 3 2 2 3 3 2 2 2 2 2 3 3 3 3 2 2 2 2 2 2 2 2 3 2 3 3 3 2 3 3 3 3 3 3 3 2 2 3 3 3 5 
5 3 2 2 3 3 2 2 2 2 2 3 3 3 2 3 3 3 2 3 3 3 3 2 2 2 3 2 2 3 2 3 3 3 3 2 3 2 3 3 2 2 3 3 3 2 2 2 2 5 
5 3 2 3 3 2 2 3 2 3 3 3 3 2 3 2 3 2 2 3 3 3 2 2 2 3 2 3 3 2 3 2 2 2 2 3 3 3 3 3 2 2 2 2 3 3 2 2 2 5 
5 3 2 3 2 3 2 2 2 2 2 2 2 2 3 2 2 3 2 3 2 2 2 2 2 3 3 2 3 3 2 3 3 2 3 2 2 3 2 3 3 3 2 2 2 2 3 2 2 5 
5 3 3 2 2 2 2 2 3 2 3 3 3 3 2 3 2 3 2 3 3 3 2 3 2 2 2 3 3 2 3 2 3 3 2 2 3 3 2 3 2 2 2 2 2 2 2 2 2 5 
5 2 2 2 3 2 3 3 3 3 2 2 3 3 2 2 2 2 3 2 3 2 2 2 2 2 2 2 2 3 3 2 3 2 3 2 2 2 2 2 3 3 2 3 3 2 2 3 3 5 
5 3 2 2 2 2 2 2 3 2 2 3 2 2 3 2 3 3 2 2 3 2 3 3 3 2 2 2 3 2 2 2 2 2 2 2 2 3 2 3 2 2 3 3 3 3 3 3 2 5 
5 2 2 2 2 2 3 3 3 3 3 3 2 2 3 3 2 2 3 2 2 3 2 3 3 2 3 2 2 2 2 2 3 3 2 2 3 3 3 2 2 2 2 3 3 3 2 3 2 5 
5 3 2 3 2 2 3 3 2 3 2 2 3 2 2 3 2 3 3 2 3 2 3 3 2 2 2 3 2 2 3 2 3 3 2 3 3 2 2 2 3 3 3 3 2 2 3 2 2 5 
5 2 3 3 3 2 3 2 2 3 2 2 3 2 2 3 3 2 2 3 2 2 3 2 2 3 2 2 3 2 3 2 2 2 3 2 2 3 3 2 3 3 3 2 3 3 2 2 3 5 
5 2 2 3 3 3 2 3 2 2 2 3 2 2 3 3 3 3 3 2 3 3 2 2 2 2 3 3 2 2 3 3 3 3 2 2 3 2 2 2 3 2 2 3 2 2 3 3 3 5 
5 3 3 2 3 3 3 2 3 2 3 2 2 2 2 3 3 3 2 2 3 3 2 2 2 3 3 2 3 2 3 3 2 2 3 2 3 3 2 3 3 2 2 3 3 2 3 3 2 5 
5 2 3 2 2 3 3 2 2 2 3 2 3 3 3 2 3 2 3 2 3 3 3 2 2 2 3 2 2 2 3 2 3 3 2 2 3 3 2 3 3 3 2 2 2 3 3 2 3 5 
5 2 3 2 3 3 2 3 2 3 3 2 2 2 3 2 3 3 3 3 3 3 2 2 3 3 3 3 2 2 3 3 3 2 2 3 2 2 3 3 2 2 2 3 3 3 3 2 3 5 
5 3 2 2 2 3 2 3 3 2 2 2 2 3 3 3 3 3 2 3 2 3 2 2 2 3 3 3 2 3 3 3 2 2 2 3 3 3 2 2 2 3 3 2 3 3 3 3 3 5 
5 2 2 3 3 3 2 3 3 3 3 3 3 3 3 3 2 2 2 3 3 3 3 2 2 2 2 3 2 3 2 3 3 3 3 2 3 2 2 2 3 2 2 2 3 3 3 3 2 5 
5 3 3 3 2 3 3 2 3 3 3 3 3 2 2 3 2 3 2 3 2 2 2 3 3 2 2 3 2 3 2 2 3 2 3 2 3 2 3 2 2 2 2 2 3 3 3 2 2 5 
5 5 5 5 5 5 5 5 5 5 5 5 5 5 5 5 5 5 5 5 5 5 5 5 5 5 5 5 5 5 5 5 5 5 5 5 5 5 5 5 5 5 5 5 5 5 5 5 5 5 
